Song 	Artist 	Genre 	Cluster
Sekunden	Swod	Electronic	C1
"Walk Into River"	"Mychael Danna"	Soundtrack	C1
"33 Fainting Spells"	"Orla Wren"	Electronic	C1
"I Have Dreamed"	"Lena Horne[Galvanize"	Rock	C1
Obsession-Compulsion	Sadist[Zigeunerweisen	Rock	C1
"September Song"	"Tony Bennett[Adios Nonino"	Jazz	C1
"Otello: Ave Maria"	"Renata Tebaldi"	Classical	C1
"September Song"	"Tony Bennett"	Jazz	C1
"Sooprize Package"	"Mean Things"	Alternative	C1
Gitanoss	Ararat	"New Age"	C1
"Otello': Ave Maria"	"Renata Tebaldi"	Classical	C1
"The Highest Point of Living"	"City of Ashes"	Rock	C1
"Let's Get Together"	"Little Trouble Kids"	Rock	C1
Love	"Gerard Kenny"	Pop	C1
"Christmas Dreaming"	"Dennis Day"	Vocal	C1
"Concerto no. 1 in E Major` Op. 8` RV 269` 'La primavera': II. largo"	Tarahumara	Classical	C1
"A Feather Is Re-Glued to the Flight"	Ginormous	Electronic	C1
"Theme From Schindler's List"	"Stadtmusikkapelle Landeck[gfd035"	Soundtrack	C1
"Collector of Remains"	"Brighter Death Now"	Rock	C1
"Crazy World (from 'Victor/Victoria')"	"Henry Mancini"	Soundtrack	C1
"Over the Sea to Sky"	"Eric Rigler"	Holiday	C1
Nacht	Dimitar Dodovski	Dance	C1
Handwriting (Part II)	Talvihorros	Electronic	C1
"Telegram` Pts. 1-3 (Live)]"	Nazareth	Rock	C2
Crown]	"Chimera Sound Healing"	"New Age"	C2
Revenge]	"Alleycat Scratch "	Rock	C2
Reverie]	"Dustin Gledhill "	"Christian & Gospel"	C2
Jim]	"Douglas Heart "	Alternative	C2
Lemonade]	"Moonlight Bride "	Alternative	C2
"Gas Can"	"Trance Farmers"	Alternative	C2
Friendship]	"Madrefoka  "	Jazz	C2
"Swahili Blonde Days]"	"Swahili Blonde"	Alternative	C2
"Ma m??re l'oye: V. Petit Poucet]"	"l'oye: V. Petit"		C2
"Morbius' Study]"	"Louis and Bebe Barron"	Soundtrack	C2
"Earl Grey]"	"Kaffeemusik "	"Easy Listening"	C2
"Six Studies in English Folk Song: I. Adagio (Lovely on the water)]"	"Royal Ballet Sinfonia"	Classical	C2
"A Fancy of Folksongs: III. The Crystal Spring]"	"Canterbury Chamber Choir"	Classical	C2
Aria]	"Mop Mop "	Electronic	C2
"Evening Forest Crickets]"	"Green Powered"	"New Age"	C2
Belief]	"Don Robertson "	"New Age"	C2
"Earth - Relationship` Marriage And Partnership]"	Technomind	"New Age"	C2
Din]	"Tod Dockstader "	Electronic	C2
"Good Night (Porzellan Remix)]"	Pleq	Dance	C2
Awakening]	"Neil H "	Podcasts	C2
"Kay's Theme]"	"David Julyan"	Soundtrack	C2
"Closing The Black Box]"	Wilt	"Hip Hop/Rap"	C2
"Moonlight Becomes You]"	"Billy May"	"Short Films"	C2
"Scattered` They Fly Across the Sill]"	Lattice	"New Age"	C2
"Violin Concerto No. 3 in B minor Op. 61: II. Andantino quasi allegretto]"	"Maxim Vengerov"	Classical	C2
Toraja]	"Peter Schnur "	Jazz	C3
"Tip of My Fingers (Live)]"	"Barbara Fairchild "	Country	C3
"Secret Agent]"	"Red Dons"	Alternative	C3
"He Bought My Soul at Calvary]"	"Jo Stafford"	Pop	C3
Clisto]	"Thighpaulsandra "	Alternative	C3
"the Right Defense]"	Ambisonic	Alternative	C3
"Big Wide World]"	"Teddy Randazzo"	Pop	C3
"Falling in Love Again (feat. Michael Lutzeier)]"	"Lee Shaw Trio"	Jazz	C3
"Red House]"	Whiskey	Pop	C3
Time]	"Interference"	Alternative	C3
"Caught in the Wake]"	"Hope & Social"	Alternative	C3
Run]	DUKATALON	Rock	C3
"Unkaany Valley]"	"Birds of Avalon"	Alternative	C3
"Cast Out]"	"Cross Stitched Eyes"	Alternative	C3
Lies]	"Cause for Alarm"	Alternative	C3
"??ltima Volta]"	"Ecos Falsos"	Rock	C3
Maybe]	A.D.D.	Fantasy	C3
Soldatslakt]	S??tlimpa	Alternative	C3
Will]	Out	Alternative	C3
"Pseudo Existence"	"Pseudo Existors"	Alternative	C3
"What Comes Around Goes Around (Live)]"	"Catch 22"	Alternative	C3
Ocular]	Aly	Alternative	C3
Maul]	Kolossale Jugend	Alternative	C3
Shoot]	Super Deluxe	Rock	C3
"People of Your Kind]"	"Beat Mark"	"Biography & Memoir"	C3
"I Go Vertigo]"	Minus	Rock	C3
Cold]	"Sudden Death"	Rock	C3
"From Dust and Gravity]"	Monsterworks	Rock	C3
"From up Here]"	"One Event Worship Team"	"Christian & Gospel"	C3
"Spiders Functions]"	Pigsty	Rock	C3
"A Bitter Pill]"	JDA	Rock	C3
"Illusional Dementia]"	"Fractal Gates"	Rock	C3
"Woman Beater (Unreleased Bonus Tracks)]"	"The Unseen"	Alternative	C3
"SEVENTH HEAVEN]"	POLYSICS	Rock	C3
"Eaten by Rats]"	Blohole	Alternative	C3
"Through the Unhindered Break of Day]"	"Set and Setting"	Podcasts	C3
Scoundrel]	Alva Leigh	Alternative	C3
"Jesu` Joy of Man's Desiring]"	Tribe	"Performing Arts"	C3
"El Rey de la Revolucion (En Vivo)]"	"Three Souls in My Mind"	"Alternativo & Rock Latino"	C3
"Faber - Emptiness]"	Faber	"Fiction & Literature"	C3
"Big Fuss]"	Antennas	Alternative	C3
Fever]	Delacroix	Dance	C3
"Free Society]"	"Overdrive "	Rock	C3
"Paper Doll"	"The Dead Exs"	Blues	C4
Mevlana	"Mustafa Kand_`ral_`"	World	C4
"Dag En Nacht"	"De Selvera's"	World	C4
Summer	Gomorrha	Pop	C4
"Staie cca"	"Franco Moreno"	Pop	C4
"Gaelic Waltzes"	Skipinnish	World	C4
"Y Ferch Yn Y Swyddfa"	Datblygu	Alternative	C4
"Amor Ti Vieta (from 'Feodora')"	"Mario del Monaco"	Classical	C4
"Be My Shade"	"Jeans Wilder"	Alternative	C4
"Stormy Late Fall"	Campfires	Rock	C4
"Inklabete H' Sine / El Manantial De Tus Ojos"	"Salim Fergani"	World	C4
"Hold My Trophy (feat. Kyle Gass)"	"Trey Green"	Rock	C4
"Las Torres De Mi Sevilla"	"El Pali"	Raices	C4
"All Your Promises"	"Georgian Banov"	"Christian & Gospel"	C4
"Shannon Maclaughlin"	"Kyle Van Band"	Rock	C4
"Prenez mes fleurettes"	Mistinguett	"French Pop"	C4
"Yade Rebene"	Rojda	World	C4
Majesty	"Leonard Jones"	Chris	C4
"Mother of Christ (remix&remaster)"	"Alice Donut"	Alternative	C4
"A coups de batte"	"Les Sheriff"	Rock	C4
"This Curse"	Coldcast	Electronic	C4
B??ztat??	"H??tk??znaPI CSal??d?_sok"	"Christian & Gospel"	C4
"Thanksgiving (Live Track)"	"Poi Dog Pondering"	Rock	C4
"Higher Than Life"	"Mike Lang"	"Biography & Memoir"	C4
"Joining The Past"	"Obtained Enslavement"	Rock	C4
"Violet's Turning Violet"	"Carving Out Fiction"	Rock	C4
Barnburner	"The Chair"	Alternative	C4
"God You Are Good"	"Sophia Jenkins"	Pop	C4
"Sorry Song"	"The Gamits"	Rock	C4
"Lightening Strikes (Live)"	"The Seers"	Rock	C4
"Hispanic Panic"	Koresh	"Hip Hop/Rap"	C4
"Still Remains"	"2 Ton Predator"	Alternative	C4
"Open Your Mind"	Sunray	Rock	C4
"Don't Wait"	"Greg Pope"	Pop	C4
"Travelin' Light"	"Rollin' in the Hay"	Country	C4
"La lune ~odoriko~"	Madoka	International	C4
"Man Overboard"	Plankton	Rock	C4
"Come On W Man"	"No Remorse"	"Heavy Metal"	C4
"Lock Us Away"	"Naked Aggression"	Alternative	C4
"Big Cheese"	"Adam Holzman"	Classical	C4
"Won't You"	Plasmatics	Rock	C4
"News of the world"	"October powder"	Alternative	C4
"Running With Scissors"	"Call To Mind"	Alternative	C5
"A Lovely Way to Spend an Evening"	"Little Anthony & The Imperials"	R&B/Soul	C5
"Letting Go"	"Eric Durrance"	Country	C5
"I'll Give My Heart"	"Integrity Music"	"Christian & Gospel"	C5
"Broken Hopes` Brokes Lives"	Embers	Electronic	C5
"Big World"	"Happy Diving"	Alternative	C5
"The Fear"	Excelsis	Rock	C5
"Interstellar Overdrive"	Spiha	Rock	C5
Intro	Offpist	Alternative	C5
Palim	"Wind Und Farben"	Rock	C5
Collectibles	"Hold Tight"	Electronic	C5
"At Times Like These"	"From The Tracks"	Alternative	C5
"Before I Drown"	Endsight	Rock	C5
"TAKING IT BACK (ALIVE)"	"Phone Joan"	Rock	C5
"J.A.S.P (Joven Aunque Sin Pelo)"	Mordor	Dance	C5
"The Plunderer"	"Naer Mataron"	Rock	C5
"The Plunderer"	"Naer Mataron"	Rock	C5
"A Whole Wide World Ahead"	"Disco Inferno"	Alternative	C5
"To Minore Tis Avgis"	Anastasia	Pop	C5
"The Ethereal Dream"	"Tomorrow's Outlook"	Rock	C5
"Farewell the Ultimatum"	PMtoday	Rock	C5
"Apart (Don't Dream Me Bad)"	ardentjohn	Alternative	C5
"Alla Bara Skriker"	Grace.Will.Fall	Alternative	C5
Zompires	"All the Saints"	Pop	C5
"Telling All The World (Live)"	Flickerstick	Rock	C5
"Geladene Gewehre"	Kreisky	Drama	C5
Protest	"Electro Hippies"	Rock	C5
Genesis	"Memory Garden"	Rock	C5
Rapture	Zangryus	Rock	C5
"What I Was"	Bailiff	Rock	C5
"Buscando Mirando"	Leize	Rock	C5
"Glory Girl (Boy George & Kinky Roland's The Free Man In Paris Mix)"	"Amanda Ghost"	Pop	C5
"Heavy Snake"	Peelander-Z	Alternative	C5
"Intestinal skirmish"	10lec6	Alternative	C5
"Gaelic Waltzes"	Skipinnish	World	C5
Generations	Slowburn	Rock	C5
"The Long Road"	Domenica	Rock	C5
"Ruined / Wasted"	"We Were Skeletons"	Rock	C5
U.S.A.	"Hymnen Orchestra"	"Spoken Word"	C6
"Libra Sonatine: III. Fuoco"	"Magdalena Kaltcheva"	Classical	C6
"Hark` The Herald Angels Sing"	"The Lennon Sisters"	Holiday	C6
"Between a Donkey and a Rolls Royce"	"Graham Collier"	Classics	C6
"Rogar (remastered)"	"Los Cinco Latinos"	Latin	C6
"Rogativas a Nuestra Se?`ora del Milagro"	"Joaqu??n D??az"		C6
"Colours (Blackout)"	indigolab		C6
"Tribute To Brian Jones"	"Karl Schmieder"	Blues	C6
"Cuando Ya No Me Quieras"	"Antonio Prieto"	"Baladas y Boleros"	C6
"The Music of Home"	"Anthony Perkins"	Pop	C6
"Scott Walker's Fault"	"The Minus 5"	Rock	C6
"Beautiful Diamond"	DBrass	"Christian & Gospel"	C6
Harmonik	"David Coulter"		C6
"I'm Trying Love Again"	"Sir Joe"		C6
Villancete	"Nicanor Zabaleta"	Classical	C6
"Nature Baby"	"Tammy Townsend"	R&B/Soul	C6
"In My Room"	"OC Times"	Vocal	C6
"Tears Will Never Stain the Streets of That City"	"The Rambos"	"Fiction & Literature"	C6
"Stay Here With Me"	"Dick Smart"	Jazz	C6
Sinistre	Fugu	Alternative	C6
"I Never Go There Anymore"	"Rita Moss"	Holiday	C6
"Stabat Mater IXXI"	"Sasha & Shawna"	Vocal	C6
"Der e ingi dag'e"	Lumsk	Rock	C6
"When I Hold Her Near"	"Jack Stillwater"	Country	C6
"Le Shavore"	Mitsoura	International	C6
"Hamkhooneh (with Hayedeh)"	Vigen	Pop	C6
Bryllupsmarsj	"Knut Nystedt"	"Christian & Gospel"	C6
"The Tsunami Trail"	"Rhonda Rosalee"	"New Age"	C6
"What's New"	"Jackie Gleason"	Pop	C6
"Aquila altera (Codex Faenza)"	"Ensemble Project Ars Nova"	Classical	C6
"Solemn Vespers for the Feast of a Confessor` K. 339: II. Confitebor"	"Ama Deus Ensemble"	Classical	C6
"My Prayer"	"Jimmy Dorsey"	Jazz	C6
"Except For Me"	"Broken Rules"	Rock	C6
"My wife"	Shadowplay	Alternative	C6
"Sans violence"	"Toi et Moi"	Pop	C6
Menino	"Trio Con Brio"	Classical	C6
"Offering (Epiphany)"	"Marian Grace"	Holiday	C6
"The Witness"	"Chocolate Tannoy"	Electronic	C6
"midnight violence rocknroll"	"Guitar Wolf"	Rock	C6
"Five Grown Men (Holding Hands and Staring at the Ocean) "	" Palehorse "	"Heavy Metal"	C7
"Ride On Preacher "	" Smokin' Hogs "	Blues	C7
"Prologue "	" Tara Kemp "	R&B/Soul	C7
"Merrizine "	" God Among Men "	Rock	C7
"James Lighter "	" Wounded Knee "	Alternative	C7
"La Vida Es un Loop "	" Burrito Panza "	Pop	C7
"Horizontime "	" Codec "	Rock	C7
"Fury "	" Dam "		C7
"The Return of David Dun "	" Star Industry"	Electronic	C7
"Jesu Dod (Burzum) "	" Kroda "	Rock	C7
"II "	Aborym	Rock	C7
"Maiden "	" Bahamut "	Electronic	C7
"King Lindorm "	" Guapo "	Alternative	C7
"Space Invaders "	" Frontier "	Fiction	C7
"Woeful Cries "	" B-Zet "	Pop	C7
"Tales of Sorcery "	" Anal Vomit "	Rock	C7
"Impious Genocide "	" Verminous "	Rock	C7
"Name Me No One "	" Black Cross "	Alternative	C7
"Home Invasion "	" Fire in the Head "	Alternative	C7
"On A Drive "	" Religious Knives "	Alternative	C7
"Alpha Omega (Live In Fort Lauderdale` Florida) "	" Holy"	Country	C7
"Ocularis Infernum - Tragedies to Come "	" Blodsrit "	"Heavy Metal"	C7
"Transmission of Healing or Information from an Enlightened Spirit "	" Sandra Ingerman "	"Spoken Word"	C7
"On The Burial Ground "	" Opprobrium"	Rock	C7
"Ohm "	" Markus Mehr "	Electronic	C7
"Death to Metal "	" The Senseless "	Alternative	C7
"Nostalgia Echo "	" Heiden "	"Health & Fitness"	C7
"Avalon "	" Headline "	Rock	C7
"Pure Drone 1 "	" Sheila Chandra "	World	C7
"Tune Up "	" Archipelago "	Pop	C7
"Paid Your Price "	" Sunken Seas "	Alternative	C7
"Majestic West "	" Bill Brovold"	Rock	C7
"Carcasses "	Abraham	"United States"	C8
"Libation "	"Funerary Call"	Electronic	C8
"Stalinorgel "	"EASTERN FRONT"	"Heavy Metal"	C8
"The Seeker "	"Simon Boswell"	Soundtrack	C8
"Infinity Sentinel "	"Wesley Matsell"	Dance	C8
"III "	Aborym	Rock	C8
"Batman Unmasked/Darkseid Homeworld "	"Kevin Kliesch"	Soundtrack	C8
"Vaginamaria "	Isvind	Rock	C8
Gwildophobe	Gwil	Pop	C8
"Quiet!: Sutle Pretext Chiming In "	"Das Oath"	Rock	C8
"Sea Of Shattered Hope "	Shadowchaser	Soundtrack	C8
"Town curve "	"NE Trethowan"	Electronic	C8
"Like At First Sight "	"Earl Klugh"	Jazz	C8
"Relaxamento (Musicas de Fundo para Spa e Bem-estar) "	Relaxamento	Relaxation	C8
"In The Shadows "	"Music For Meditation & Relaxation"	"New Age"	C8
"Invocation  "			C8
"Hidden Track "	Danzig	Rock	C8
"Melange "	"Ron Marvin"	Pop	C8
"Your Hell Begins "	Howl	"Heavy Metal"	C8
"Like Lemonade` But Better "	1518	Rock	C8
"Live Forever "	Kromosom	Rock	C8
"Thighs "	"Kirin J Callinan"	Alternative	C8
"Supposed to Stay Hidden "	"Josh Aker"	Soundtrack	C8
"Touch Back Down - Live At The Spitz "	"Catherine Feeny"	Singer/Songwriter	C8
"Le naprej "	"Dan D"	Pop	C8
"A Sysyphus Drama "	Carnality	"Heavy Metal"	C8
"Harvesting the Blood "	Avulsed	Rock	C8
"Lies On Display "	Heist	Dance	C8
"Dor-Lohmyn "	Minhyriath	"Heavy Metal"	C8
"Dawn Of Hope No Choir "	"Gothic Storm"	Soundtrack	C8
"Blood On Blood - Intro "	"Cem K??ksal"	International	C8
"Maiden "	Bahamut	Mystery	C8
"TIGER "	"MO'SOME TONEBENDER"	Rock	C8
"To God Be the Glory (Tribute) "	Vinesong	"Christian & Gospel"	C8
"All Nights Rest "	"Trevor Giuliani"	Pop	C8
"Together With The Sunbeams `\"	Bolot	Drama	C8
"The Ballad of Century Paul "	"Songs of Green Pheasant"	Alternative	C8
"Transition "	Assem	Electronic	C8
"Trondheim II: IV "	"Henry Cow"	Alternative	C8
"`Eg Heyrdi Allt An Pess Ao Hlusta` "	"J??hann J??hannsson"		C9
"Memoirs: V. In Memoriam "	"Ciompi Quartet"	Classical	C9
"Hinikoita "	Akasau	International	C9
Hushaby	"Max Q"	Vocal	C9
"Hornpipes & Reels: Beverley's Choice` Niall From Glenroe` Wellesley Express` Katrina Baker` Bee Street Fiddlers "	"Bruce Gandy"	World	C9
"Nzambi La Muini"	"Cut Hands"	Electronic	C9
"Pr??lude ?` l'apr??s-midi d'un faune` L. 86 "	"Claude Debussy"	Classical	C9
"Requiem  "			C9
"in memoriam Josquin Desprez ?` 6 voix: II. Kyrie "	"Huelgas Ensemble"	Classical	C9
"Track 2 "	Sundrips	Dance	C9
"Bedding the Queen "	"Thomas Wander"	Soundtrack	C9
"Crepusculum "	"Emile van Krieken"	Soundtrack	C9
"Calming Anxiety "	"Ingrid Hennze"	"Christian & Gospel"	C9
"Landmannalaugar (Part 1) "	"Jens Lueck"	Soundtrack	C9
"Symphony No. 1 in C-Minor` Op. 68: II. Andante sostenuto "	"William Steinberg"	Classical	C9
"Final Playback/ End Titles "	"James Horner"	Soundtrack	C9
"Looking For Simon "	"John Barry"	"Spoken Word"	C9
"The Painful Truth "	"As Hope Dies"	Rock	C9
"Grounded "	"Nathan Johnson"	Soundtrack	C9